NO ./assets/xpm/blue.xpm
EA ./assets/xpm/green.xpm
SO ./assets/xpm/yellow.xpm
WE ./assets/xpm/red.xpm
F 220,100,,

	1111111
   111111111
  11111111111
 111110001111111111111111111111111111111111111111111111111111111111111
111110000000000000000000000000000000000000000000000000000000000000011111
111100000000000000000000000000000000000000000000000000000000000000001111
1111000000000000000000000000000000000000000000000000000000000000001111
1111000000000000000000000000000000000000000000000000000000000S0001111
11110000000000000000000000000000000000000000000000000000000000001111
11110000000000000000000000000000000000000000000000000000000000001111
11111000000000000000000000000000000000000000000000000000000000000011111
 1111100000000000000000000000000000000000000000000000000000000011111
  11111111111111111111111111111111111111111111111111111111111111111111
   11111111111111111111111111111111111111111111111111111111111111111
	11111111111111111111111111111111111111111111111111111111111111




   11111111111111111111111
   110000000000000000001
   111111111111111111111

   C 225,30,0