NO ./assets/xpm/blue.xpm
EA ./assets/xpm/green.xpm
SO ./assets/xpm/yellow.xpm
WE ./assets/xpm/red.xpm
F 220,100,0
C 30,30,225

		1111111111111111111111111
		1000000000110000000000001
		1011000001110000000000001
		1001000000000000000000001
111111111011000001110000000000001
1000000000110000011101111000111111
11110111111111011100000010001
11110111111111011101010010001
11000000110101011100000010001
10000000000000001100000010001
10000000000000001101010010001
11000001110101011111011110N0111
11110111 1110101 101111010001
11111111 1111111 111111111111