NO ./assets/xpm/blue.xpm
EA ./assets/xpm/green.xpm
SO ./assets/xpm/yellow.xpm
WE ./assets/xpm/red.xpm

F 161,12,12
C 57,1,0

    11111111111111111111111
      1000S0000000000011111
  111111100000000000000001
11100000001000000000011111
1111100000010000000000111111
    1100000011000000000000111
1111100000111111000001000000011
10000000001000000000011011111
100000001110000000111110111
1000000000100000111 1000001
11111000010000001  110010011
1000101110100001   1000110011111111
1000000000000111   110010000000001
111111111101111     101111111111111
      100000001111111011111
  1111100000000000000001
111000000000000001000111
111110000000000111111111111
    1100011000000100000000111
111110000001111000100000000011
10100000000100000000011011111
101011111100000000111110111
1000100001000000111 1000001
11111001100000001  110000011
10001001000000011  1000000011111111
1000000000000111   110000000000001
11111111111111      111111111111111