NO ./assets/xpm/blue.xpm
EA ./assets/xpm/green.xpm
SO ./assets/xpm/yellow.xpm
WE ./assets/xpm/red.xpm

C 186,199,45
F 225,30,0

11111111111111111111111
      100000000000000011111
  1111100000000000000001
111000000000000000000111
111110000000000000000111111
    1100000000000000000000111
111110000000N00000000000000011
10000000000000000000011111111
100000000000000000111111111
1000000000000000111 1000001
11111000000000001  110000011
10001000000000001  1000000011111111
10000000000001111  1100000000000001
11111111111111      111111111111111