NO ./assets/xpm/wall/wall3.xpm
EA ./assets/xpm/wall/wall3.xpm
SO ./assets/xpm/wall/wall3.xpm
WE ./assets/xpm/wall/wall3.xpm
F 220,100,0
C 225,30,0

                                                      111
                                                      101
111111111111111111111111111111111111111111111111111111101
100000000000000000000000000000N000000000P0000000000000001
111111111111111111111111111111111111111111111111111111111